

WE sprites/32/crystal.xpm
EA sprites/32/rock.xpm
NO sprites/32/water.xpm
SO sprites/32/ship_left.xpm

F 220,100,0
C 225,30,0

11111111111111111111111111111
11110111111111011101010010001
11000000110101011100000010001
10000000000000000000000000001
1000000N000000001101010010001
1100000111010101111101111000111
11110111 1110101 101111010001
11111111 1111111 111111111111