WE sprites/water.xpm
EA sprites/crystal.xpm
NO sprites/rock.xpm
SO sprites/ship_left.xpm
C 255,255,35
F 255,20,147
                   
                   
111111111111       
100000000001      1
10N0000000011111111
1000000000000000001
1111111100000001001
       111111101111
       100000000011
       100000000001
       111111111111
                   




