WE sprites/water.xpm
EA sprites/crystal.xpm
NO sprites/rock.xpm
SO sprites/ship_left.xpm
C 255,255,35
F 255,20,147
                                       11
                      11111           1101
111111111111       111000001111111111100001
100000000001      1000000000000000000000001
1000000000011111111000000000000000000000001
1E0000000000000000000000000000000111111111
111111110000000100000111111111111
       111111101111111 10001
       100000000010001 10001
       100000000000101  000
       111111111111101
                    10




