WE sprites/water.xpm
EA sprites/crystal.xpm
NO sprites/rock.xpm
SO sprites/ship_left.xpm


C 255,255,0
F 255,20,147


111111111111111111111111111111
1N0000000000000000000000000001
100000000000000000000000000001
100000000000000000000000000001
100000000000000000000000000001
100000000000000000000000000001
100000000000000000000000000001
100000000000000000000000000001
100000000000000000000000000001
100000000000000000000000000001
100000000000000000000000000001
100000000000000000000000000001
100000000000000000000000000001
100000000000000000000000000001
100000000000000000000000000001
100000000000000000000000000001
100000000000000000000000000001
100000000000000000000000000001
111111111111111111111111111111
