WE sprites/water.xpm
EA sprites/crystal.xpm
NO sprites/rock.xpm
SO sprites/ship_left.xpm


C 255,255,0
F 255,20,147


111111111111111111
100000000000000001
111011111111111101
11N000000000000101
110000000100000101
100000000100000101
100000000100000101
100000000100011101
100000000100010001
100000000100010101
100000000100010101
101111111110111010
100111111110111011
100000000000000010
111111111111111111