WE sprites/water.xpm
EA sprites/water.xpm
NO sprites/water.xpm
SO sprites/water.xpm
F 122,200,122
C 122,122,122





111111
1N0001
100001
100001
111111