WE sprites/64/wallw.xpm
EA sprites/64/walle.xpm
NO sprites/64/walln.xpm
SO sprites/64/walls.xpm
C 130,10,35
F 20,160,220
011111110
111101111
110000001
10E000001
011111110








