WE sprites/water.xpm
EA sprites/crystal.xpm
NO sprites/rock.xpm
SO sprites/ship_left.xpm
C 255,255,35
F 255,20,147


011111110
111101111
110000001
100000N01
011111110









