WE sprites/48/jul.xpm
EA sprites/48/walle.xpm
NO sprites/48/walln.xpm
SO sprites/48/walls.xpm
C 255,255,255
F 20,220,255
011111110
111101111
110000001
10E000001
011111110








