WE sprites/48/jul.xpm
EA sprites/48/walle.xpm
NO sprites/48/walln.xpm
SO sprites/48/walls.xpm
F 20,160,220
C 255,180,35


011111110
111101111
110000001
10E000001
011111110








