

       

WE tx/48/wallw.xpm
EA tx/48/walle.xpm
NO tx/48/walln.xpm
SO tx/48/walls.xpm

   

C 255,255,0
F 255,20,147



                              11111111       
1111111111111111111        11100000000111    
1000000000000000001       1000000000000001   
10000000000000000011111111100000000000000011 
100000000000000000000000000000000000000000001
11111111111110011000000100000111111111111111 
            111111111101111111   100001      
            100000000000010001   100001      
            100000000000000101    0000       
            1111111111111111S1               
                            10               


tab = malloc(sizeof(char *) * nb_lignes);

int max;
while(tab[i])
{
	gnl -> line;
	len -> ft_strlne;
}

